NO ./textures/N.xpm
WE ./textures/W.xpm
SO ./textures/S.xpm
EA ./textures/E.xpm 	   

F 100,0,0
C 48,48,48

            
     11111111111
    100100000011
11110000000011
1000E01100011
100000010101
10010100011
10010110001
1000000001
1000000101
10110100001
10000000001
11111011111
     1