lol

NO ./textures/sand.xpm
 
WE ./textures/smooth_stone.xpm
F  100,25,72 



SO 	./textures/wood.xpm
EA ./textures/stone.xpm 	   

C   	  135,206,235    

            
     11111111111  
     100000000001
     111010001101
    100100000011
11110000000011
100000110001111
10100010011
1000000000111
10000011101011
1000000000001
10000010000001
1011001000001
1001001000001
1001001000001
1N00000000001
111111111111
