lol
NO ./textures/brick.xpm
WE ./textures/dirt.xpm 
F  100,25,72  



SO 	./textures/gold.xpm 
EA ./textures/wood.xpm 	
C  25,23,70 



     111111111111
     100000000001
     110010001001
    100100000011
11110000000011
100000010001111
10100010011
1000000000111
10000011101011
1000000000001
10000010000001
1010001000001
1001001000001
1001001000001
1N00000000001
111111111111
