lol
    NO 
	WE 
F 

SO      l
EA 
C 

11111
110E1
111101111