lol
    NO 
	WE 
F    0   0255, 0 

SO      l
EA 
C  255,    0,  0 , ,    

111111111111111
1E1
101
111
1
1
1
1
1
1
 1
101
111
1
1