lol
    NO 
	WE 
F    100 ,  25, 72,

SO      l
EA 
C  25,23,  70,

111111111111111
100000000000001
100000001000001
10001000100111
100100000000001
100100000000001
10010000000N001
100100000000001
100000000000001
111111111111111
