lol
    NO 
	WE 
F    0   0255, 0 

SO      l
EA 
C  255,    230,  0 , ,    

111111111111111
100000001
110000001
1N01000101
11100000001
111111111111111