lol
    NO 
	WE 
F    0   0255, 0 

SO      l
EA 
C  255,230,  0 

111111111111111
100000000000001
100000001000001
1N0001000100111
100100000000001
101111111110111
101       101
101111111110111
100000000000001
111111111111111
