lol
    NO 
	WE 
F 

SO      l
EA 
C 

1
1
1111
11111
11E101111
  111