lol
    NO 
	WE 
F    0   0255, 0 

SO      l
EA 
C  255,    255,  0 , ,    

111111111111111
10000W0000001
10000000100001
10000000100001
10010000100111
10001010001001
101011 110111
1001 110001
1011 10001
1011 10111
11111111
111