lol
    NO 
	WE 
F    0   0255, 0 

SO      l
EA 
C  255,    255,  0 , ,    

111111111111111
10000E0000001
10001010001001
101011 111111
101111
101
101
11
111