lol
    NO 
	WE 
F    0   0255, 0 

SO      l
EA 
C  255,230,  0 

1111111111 1111
1000000001
10000000111
1N00001010111
10000000001
1111111111 1111