lol
    NO 
	WE 
F 

SO 
EA 
1111111111

