lol
    NO 
	WE 
F    0   0255, 0 

SO      l
EA 
C  255,    230,  0 , ,    

111111111111111
100000000000001
100000000000001
1S0000010000001
100000000000001
100000000000001
100000000000001
111111111111111