lol
    NO 
	WE 
F    0   0255, 0 

SO      l
EA 
C  255,230,  0 

1111111111 1111
100000001
10000000111
1N110001010111
11100000001
1111111111 1111