lol
    NO 
	WE 
F 100,25, 72

SO      l
EA 
C 25,23,70

111111111111
100000000001
10010001001
100100000011
1000000000001
10000001N00111
10100010011
1010101001
10000000001
111111111111
