lol
    NO 
	WE 
F    100 ,  25, 72,

SO      l
EA 
C  25,23,  70,

111111111111
100000000001
100100010011
100100000011
10010000N001
101111111111111
11
1
1
111111111111
