lol
    NO 
	WE 
F    0   0255, 0 

SO      l
EA 
C  255,    255,  0 , ,    

111111111111111
1000000000001
10000N1000001
111011 111111
111111
1