lol
    NO 
	WE 
F    100 ,  25, 72,

SO      l
EA 
C  25,23,  70,

111111111111
100000000001
10010001001
100101000011
10010001N00111
10101011111
1010101
10101011111
10000000001
111111111111
