lol
    NO 
	WE 
F    0   0255, 0 

SO      l
EA 
C  255,    2,  0 , ,    

111111111111111
101010101101011
1N0000000000001
111111101111101
111111111111111