lol

NO ./textures/stone.xpm
 
WE ./textures/tribe.xpm
F  100,25,72 



SO 	./textures/brick.xpm
EA ./textures/wood.xpm 	   

C   	  25,23,70    

            


11111
10001
1N01 1
1111111
