NO ./textures/hexagon.xpm
WE ./textures/stars.xpm
SO ./textures/emoji.xpm
EA ./textures/rock.xpm 	   

F 100,25,72 
C 48,25,52  

            
     11111111111
    100100000011
11110000000011
1000E01100011
101000100111
1000000001
10010100001
10010010001
1000000001
11111111111
