NO ./textures/hexagon.xpm
WE ./textures/stars.xpm
SO ./textures/emoji.xpm
EA ./textures/rock.xpm 	   

F 100,25,72 
C 48,25,52  

            
     11111111111  
     100000000001
     111010001101
    100100000011
11110000000011
100000110001111
101000100111
1000000000001
1001001000001
1001001000001
1N00000000001
111111111111
