NO ./textures/lava.xpm
WE ./textures/mechanical.xpm
SO ./textures/tile.xpm
EA ./textures/rock.xpm 	   

F 34,139,34
C 25,25,112  

            
     11111111111
    100100000011
11110000000011
1000E01100011
100000010101
10010100001
10010010001
1000000001
11111011111
     1